{
  "items" : [
    "WWWWWWWWWWWWWWWWWW",
    "WCCCCXXXXCXXXWWWWW",
    "WCFFCXPXCMCXPXFFAW",
    "WCFKCXPXXXXXXXWWWW",
    "WCCCCXXXXXXMXXXCCW",
    "WWWWWWWXXMFWXXXMCW",
    "WAXXXXWEOFFWXMXWWW",
    "WXFFFXWWWWWWXXXWWW",
    "WXFFFXWXXXXXXXXXXW",
    "WXXXXXDXXXXPXXXPKW",
    "WWWWWWWWWWWWWWWWWW"
  ]
}
