{
  "items" : [
    "WWWWWWWWWWWWWWWWWW",
    "WCCCFXWCCCWCCXAWEW",
    "WCACFXWCBXPCCXKWFW",
    "WCCCFXPXCXWWWWWWDW",
    "WFFFFXWXXXXXXXXXOW",
    "WXXMXXWXXMCMXFFFXW",
    "WXXXXXWXPWWWXFMFXW",
    "WWWWXXWFFXPXXXWWWW",
    "WAFXPXWAFXPXXXBCCW",
    "WKPXDXWFFXXXXXCCCW",
    "WWWWWWWWWWWWWWWWWW"
  ]
}
