{
    "items" : [
      "WWWWWWWWWWWWWWWWWW",
      "WXXFFFFWWXXWEXFFFW",
      "WOMFFXXWWXPWXXFFFW",
      "WWWWWXXWWXXWXXXXXW",
      "WXXXXPXXXXXXXXXMXW",
      "WFFMXXXXXXXXPXXWWW",
      "WFFWWWWXXXXXPXXWWW",
      "WXXXFFWXMMXXPXXWWW",
      "WXPXMFWXXMXXXFFWWW",
      "WXPXFFWXXXXXXFFWWW",
      "WWWWWWWWWWWWWWWWWW"
    ]
}
