{
    "items" : [
      "WWWWWWWWWWWWWWWWWW",
      "WFFXXXXFFFFXXXXXXW",
      "WFWXXXMXXXXMXXXMXW",
      "WFWXXXWWDDWWXXXWWW",
      "WXMXXXWFFFFWXXPXAW",
      "WWWXXXWFCCFWXWXXWW",
      "WWWXXXWFCCFWXMXXKW",
      "WXXXXXWFCCFWXXXPKW",
      "WFFXPXWFFFFWFFWWWW",
      "WFFXPEWWWWWWFFXXOW",
      "WWWWWWWWWWWWWWWWWW"
    ]
}
