{
  "items" : [
    "WWWWWWWWWWWWWWWWWW",
    "WXXXXXXXXXXXXXXXXW",
    "WXXXXOXXXXXXXXXXXW",
    "WXXXXXXXXXBPXXXXXW",
    "WXXXXEXXXXXXPXXXXW",
    "WXXXXXXXXXXXXXXXXW",
    "WXXXXXXXXXXXXXXXXW",
    "WXXXXXXXXXXXXXXXXW",
    "WXXXXXXXXXXXXXXXXW",
    "WXXXXXXXXXXXXXXXXW",
    "WWWWWWWWWWWWWWWWWW"
  ]
}