{
    "items" : [
      "WWWWWWWWWWWWWWWWWW",
      "WFFFFFXXXXWXXXXXOW",
      "WWWWWWWWDWWXXMXXXW",
      "WFFFFFXWXXWXXWWWWW",
      "WFFPPPXXXXWXXXFFFW",
      "WFFXXXXXXXPXXXFMFW",
      "WXXFFFXWXXXXMXFFFW",
      "WWWWWWWWXXXXWXWWWW",
      "WXMFFXXXXMXXWXXFXW",
      "WXFFFXWXXXXEWXKFFW",
      "WWWWWWWWWWWWWWWWWW"
    ]
}
